NO ./assets/textures/wall_no.xpm
SO ./assets/textures/wall_so.xpm
EA ./assets/textures/wall_ea.xpm
WE ./assets/textures/wall_we.xpm

C 0, 255,0
F 255, 25,255

1111111111111111111111111111111111111111
1000000000000000000000000000000000000001
1000000000000000000000000000000000000001
1000000000100000000000000010000000000001
100000000010000000S000000010000000000001
1000000000000000000000000000000000000001
1000000000100000000000000010000000000001
1000000000000000000000000010000000000001
1000000000100000000000000000000000000001
1000000000000000000000000010000000000001
1000000000100000000000000010000000000001
1000000000000000000000000000000000000001
1000000000100000000000000010000000000001
1000000000000000000000000000000000000001
1000000000000000000000000000000000000001
1000000000000000000000000000000000000001
1111111111111111111111111111111111111111


