NO ./maps/textures/empty.xpm
SO ./maps/textures/empty.xpm
WE ./maps/textures/empty.xpm
EA ./maps/textures/empty.xpm



                
F 220,100,0
C 225,30,0

        1111111111111111111111111
111111111111111111111111111