NO ./maps/textures/empty.xpm
SO ./maps/textures/empty.xpm
WE ./maps/textures/empty.xpm
EA ./maps/textures/empty.xpm



                
F 220,100,0
C 225,30,0

		1111111111111111111111111
		1000000000110000000000001
		1011000001110000000000001
		1001000000000000000000001
111111111011000001110000000000001
100000000011000001110111111111111
11110111111111011100000010001
1111011111111101110101001001
11000000110101011100000010001
10000000000000001100000010001
10000000000000001101010010001
11000001110101010111011110N0111
11110111 0110100 101111010001
11111111 1111111 111111111111