NO ./.xpm/no_redbrick.xpm
SO ./.xpm/so_redbrick.xpm
EA ./.xpm/ea_redbrick.xpm
WE ./.xpm/we_redbrick.xpm
C 255,200,160
F 122,122,122

                                
                                
             11111111111111111
             1000000000000000111111111
             1000000000000000000000001
             1000000000000000111111111
             10000000000000001
             10000000000000001
             10000000E00000001
             10000000000000001
             10000000000000001
             10000000000000001
             10000000000000001
             10000000000000001
             11111111011111111
             11111111011111111
             11111111011111111
             11111111011111111
             11111111111111111