NO ./assets/textures/red_block.xpm
SO ./assets/textures/purple_block.xpm
EA ./assets/textures/brick_block.xpm
WE ./assets/textures/blue_block.xpm
C 0, 255,0
F 255, 25,255

11111111111111111111111111111111111111111
100000000000001      10000000000000000001
100000000000001      10000000000000000011
10000010001000111111110000100000000000011
10000000001000000000000000100000000000011
10000000000000000000000000000000000000011
10000000001000001000000000110000000000111
1000001000000001011111000100000000000011
1000000000100000101  1000000000000000001
1000000000000000001111000010000100000001
1000000000100000000000000010000000000001
1000000000000000000000000000000000000001
100000000010000000000W100010000000000001
1000000000000000000000000000000000001001
1000000000000000000000000000000000000001
1000000000000000000000000000000000000001
1111111111111111111111111111111111111111






