NO ./.xpm_1/no_redbrick.xpm
SO ./.xpm_1/so_redbrick.xpm
EA ./.xpm_1/ea_redbrick.xpm
WE ./.xpm_1/we_redbrick.xpm
C 255,200,160
F 122,122,122

111111111111
1S0000000001
111110111111
    101
111110111111
100000000001
100000000001
100000000001
100000000001
100000000001
100000000001
100000000001
100000000001
100000000001
100000000001
100000000001
111111111111